18 18 18 18 18 18 18 18 18 18 18 18 18 18 18 18 18 18 18 18 18 18 18 18 18 18 18 18 18 18 18 18 18 18 18 18 18 18 18 18 18 18 18 18 18 18 18 18 18 18 18 18 18 18 18 18 18 18 18 18 18 18 18 18 18 18 18 18 18 18 18 18 18 18 18 18 18 18 18 18 18 18 18 18 18 18 18 18 18 18 18 18 18 18 18 18 18 18 18 18 
18 18 18 18 18 18 18 18 18 18 18 18 18 18 18 18 18 18 18 18 18 18 18 18 18 18 18 18 18 18 18 18 18 18 18 18 18 18 18 18 18 18 18 18 18 18 18 18 18 18 18 18 18 18 18 18 18 18 18 18 18 18 18 18 18 18 18 18 18 18 18 18 18 18 18 18 18 18 18 18 18 18 18 18 18 18 18 18 18 18 18 18 18 18 18 18 18 18 18 18 
18 18 18 18 18 18 18 18 18 18 18 18 18 18 18 18 18 18 18 18 18 18 18 18 18 18 18 18 18 18 18 18 18 18 18 18 18 18 18 18 18 18 18 18 18 18 18 18 18 18 18 18 18 18 18 18 18 18 18 18 18 18 18 18 18 18 18 18 18 18 18 18 18 18 18 18 18 18 18 18 18 18 18 18 18 18 18 18 18 18 18 18 18 18 18 18 18 18 18 18 
18 18 18 18 18 18 18 18 18 18 18 18 18 18 18 18 18 18 18 18 18 18 18 18 18 18 18 18 18 18 18 18 18 18 18 18 18 18 18 18 18 18 18 18 18 18 18 18 18 18 18 18 18 18 18 18 18 18 18 18 18 18 18 18 18 18 18 18 18 18 18 18 18 18 18 18 18 18 18 18 18 18 18 18 18 18 18 18 18 18 18 18 18 18 18 18 18 18 18 18 
18 18 18 18 18 18 18 18 18 18 18 18 18 18 18 18 18 18 18 18 18 18 18 18 18 18 18 18 18 18 18 18 18 18 18 18 18 18 18 18 18 18 18 18 18 18 18 18 18 18 18 18 18 18 18 18 18 18 18 18 18 18 18 18 18 18 18 18 18 18 18 18 18 18 18 18 18 18 18 18 18 18 18 18 18 18 18 18 18 18 18 18 18 18 18 18 18 18 18 18 
18 18 18 18 18 18 18 18 18 18 18 18 18 18 18 18 18 18 18 18 18 18 18 18 18 18 18 18 18 18 18 18 18 18 18 18 18 18 18 18 18 18 18 18 18 18 18 18 18 18 18 18 18 18 18 18 18 18 18 18 18 18 18 18 18 18 18 18 18 18 18 18 18 18 18 18 18 18 18 18 18 18 18 18 18 18 18 18 18 18 18 18 18 18 18 18 18 18 18 18 
18 18 18 18 18 18 18 18 18 18 18 18 18 18 18 18 18 18 18 18 18 18 18 18 18 18 18 18 18 18 18 18 18 18 18 18 18 18 18 18 18 18 18 18 18 18 18 18 18 18 18 18 18 18 18 18 18 18 18 18 18 18 18 18 18 18 18 18 18 18 18 18 18 18 18 18 18 18 18 18 18 18 18 18 18 18 18 18 18 18 18 18 18 18 18 18 18 18 18 18 
18 18 18 18 18 18 18 18 18 18 18 18 18 18 18 18 18 18 18 18 18 18 18 18 18 18 18 18 18 18 18 18 18 18 18 18 18 18 18 18 18 18 18 18 18 18 18 18 18 18 18 18 18 18 18 18 18 18 18 18 18 18 18 18 18 18 18 18 18 18 18 18 18 18 18 18 18 18 18 18 18 18 18 18 18 18 18 18 18 18 18 18 18 18 18 18 18 18 18 18 
18 18 18 18 18 32 36 37 38 39 40 18 18 18 18 18 18 18 18 18 18 18 18 18 18 18 18 18 18 18 18 18 18 18 18 18 18 18 18 18 18 18 18 18 18 18 18 18 18 18 18 18 18 18 18 18 18 18 18 18 18 18 18 18 18 18 18 18 18 18 18 18 18 18 18 18 18 18 18 18 18 18 18 18 18 18 18 18 18 18 18 18 18 18 18 18 18 18 18 18 
27 25 25 25 25 41 42 43 33 34 35 25 25 25 25 25 25 25 25 25 25 25 25 25 25 25 25 25 25 25 25 25 25 25 25 25 25 25 25 25 25 25 25 25 25 25 25 25 25 25 25 25 25 25 25 25 25 25 25 25 25 25 25 25 25 25 25 25 25 25 25 25 25 25 25 25 25 25 25 25 25 25 25 25 25 25 25 25 25 25 25 25 25 25 25 25 25 25 25 25 
23 0 0 0 0 0 1 1 1 0 0 0 0 0 0 0 0 0 0 0 0 0 0 0 0 0 0 0 1 1 0 0 0 0 0 0 0 0 0 0 0 0 0 0 0 0 0 16 16 16 16 16 16 16 16 16 16 16 16 16 16 16 16 16 16 16 16 16 16 16 16 16 16 16 16 16 16 16 16 16 16 16 16 16 16 16 16 16 16 16 16 16 16 16 16 16 16 16 16 16 
23 0 0 0 0 0 0 0 0 0 0 0 0 0 0 0 0 0 0 0 0 0 1 1 1 0 0 0 0 0 0 0 0 0 0 1 1 0 0 0 0 0 1 1 0 0 0 16 16 16 16 16 16 16 16 16 16 16 16 16 16 16 16 16 16 16 16 16 16 16 16 16 16 16 16 16 16 16 16 16 16 16 16 16 16 16 16 16 16 16 16 16 16 16 16 16 16 16 16 16 
29 21 0 0 0 0 0 0 0 0 1 0 0 0 0 0 0 0 0 0 0 0 0 0 0 0 0 0 0 0 0 0 0 0 0 0 0 0 0 0 0 0 0 0 0 0 0 16 16 16 16 16 16 16 16 16 16 16 16 16 16 16 16 16 16 16 16 16 16 16 16 16 16 16 16 16 16 16 16 16 16 16 16 16 16 16 16 16 16 16 16 16 16 16 16 16 16 16 16 16 
18 29 20 20 21 0 0 0 0 0 0 0 0 0 0 0 0 0 0 0 0 0 0 0 0 0 0 0 0 0 0 0 0 0 16 16 16 0 0 16 16 0 0 0 0 0 0 16 16 16 16 16 16 16 16 16 16 16 16 16 16 16 16 16 16 16 16 16 16 16 16 16 16 16 16 16 16 16 16 16 16 16 16 16 16 16 16 16 16 16 16 16 16 16 16 16 16 16 16 16 
18 18 18 18 29 21 0 0 0 0 0 0 0 0 0 0 0 0 0 0 0 0 0 0 0 0 0 0 0 0 0 0 16 16 16 16 16 16 16 16 16 0 0 0 1 0 0 16 16 16 16 16 16 16 16 16 16 16 16 16 16 16 16 16 16 16 16 16 16 16 16 16 16 16 16 16 16 16 16 16 16 16 16 16 16 16 16 16 16 16 16 16 16 16 16 16 16 16 16 16 
18 27 25 28 18 29 20 21 0 0 0 0 0 1 0 0 0 1 0 0 0 0 0 0 0 0 0 0 0 0 16 16 16 16 16 16 16 16 16 16 16 16 0 0 0 0 0 16 16 16 16 16 16 16 16 16 16 16 16 16 16 16 16 16 16 16 16 16 16 16 16 16 16 16 16 0 0 0 0 0 0 0 0 0 0 0 0 0 16 16 17 17 17 17 17 17 17 16 16 16 
18 23 0 24 25 28 18 29 20 21 0 0 0 0 0 0 0 0 0 0 0 0 0 0 0 0 16 16 16 16 16 16 16 16 16 16 16 16 16 16 16 16 0 0 0 0 0 16 16 16 16 16 16 16 16 16 16 16 16 16 16 16 16 16 16 16 16 16 16 16 16 16 16 0 0 0 0 0 0 0 0 0 0 0 0 0 0 0 0 7 17 15 15 15 15 15 17 16 16 16 
18 23 0 0 0 24 25 28 18 29 20 21 0 0 0 0 0 0 0 0 0 0 0 0 0 16 16 16 16 16 16 16 16 0 0 0 0 16 16 16 16 0 0 0 0 0 0 16 16 16 16 16 16 16 16 16 16 16 16 16 16 16 16 16 16 16 16 16 16 16 16 16 0 0 0 0 0 0 0 0 0 0 0 0 0 0 0 0 0 7 17 15 15 15 15 15 17 16 16 16 
18 23 0 0 0 0 0 24 25 25 28 29 21 0 0 0 0 0 0 0 0 0 0 0 0 0 0 0 16 16 0 0 0 0 0 0 0 0 0 0 0 0 0 0 0 0 0 16 16 16 16 16 16 16 16 16 16 16 16 16 16 16 16 16 16 16 16 16 16 16 16 16 0 0 0 0 0 0 0 0 1 0 0 0 0 0 0 0 0 7 17 17 17 15 17 17 17 16 16 16 
18 23 0 0 0 0 0 0 0 0 24 28 29 21 0 0 0 0 0 0 0 0 0 0 0 0 0 0 0 0 0 0 0 0 0 0 0 0 0 0 0 0 0 0 0 0 0 0 16 16 16 16 16 16 16 16 16 16 16 16 16 16 16 16 16 16 16 16 16 16 16 16 0 0 0 0 0 0 0 0 0 0 1 0 0 0 0 0 0 13 4 4 5 2 3 4 16 16 16 16 
18 23 0 0 1 0 0 0 1 0 0 24 28 29 21 0 0 0 0 0 0 0 0 0 0 0 0 0 0 0 0 0 1 0 0 0 0 0 0 0 1 0 0 0 0 0 0 0 0 0 0 0 0 0 16 16 16 16 16 16 16 16 16 16 16 16 16 16 16 16 16 16 0 0 0 0 0 0 0 0 1 1 0 0 0 0 1 0 0 0 0 0 7 2 6 0 16 16 16 16 
18 23 0 0 0 0 0 0 0 0 0 0 24 28 29 20 21 0 0 0 0 0 0 0 0 0 0 0 0 0 0 0 0 0 0 0 0 0 0 0 0 0 0 0 0 0 0 0 0 0 0 0 0 0 0 0 0 16 16 16 16 16 16 16 16 16 16 16 16 16 16 16 0 0 0 0 0 0 0 0 0 0 0 1 0 0 0 0 0 0 0 0 7 2 6 0 0 16 16 16 
18 23 0 0 0 0 0 0 0 0 0 0 0 24 28 18 23 0 0 0 0 0 0 0 0 0 0 0 0 0 0 0 0 0 0 0 1 0 0 0 0 0 0 0 0 0 0 0 0 0 0 0 0 0 0 0 0 0 0 16 16 16 16 16 16 16 16 16 16 16 16 16 16 16 0 0 0 0 0 1 0 0 0 0 0 1 0 0 0 0 0 0 7 2 6 0 0 16 16 16 
18 23 0 0 0 0 0 0 1 0 0 0 0 0 24 25 26 9 9 9 9 9 9 9 9 9 9 9 9 12 0 0 16 0 0 0 0 0 0 0 0 0 1 0 0 0 0 0 0 0 0 0 0 0 0 0 0 0 0 16 16 16 16 16 16 16 16 16 16 16 16 16 16 16 16 0 0 0 0 0 0 0 0 0 0 0 0 0 0 0 0 0 7 2 6 0 0 16 16 16 
18 23 0 1 0 0 0 0 0 0 0 0 0 0 15 15 15 2 2 2 2 2 2 2 2 2 2 2 2 8 9 9 12 0 0 0 0 0 0 0 0 0 0 0 0 0 0 0 0 0 0 0 0 0 0 0 0 0 0 16 16 16 16 16 16 16 16 16 16 16 16 16 16 16 16 16 16 16 16 16 16 16 16 0 0 0 0 0 0 0 0 0 7 2 6 0 0 16 16 16 
18 23 0 0 0 0 0 0 0 0 0 0 0 0 19 20 21 4 4 4 4 4 4 4 4 4 4 5 2 2 2 2 8 0 0 0 12 0 16 0 0 0 0 0 0 0 0 0 0 0 0 0 0 0 0 0 0 11 9 9 9 9 9 9 9 9 9 9 9 9 9 9 9 9 9 9 9 9 9 9 9 9 9 9 9 9 9 9 9 9 9 9 10 2 6 0 0 16 16 16 
18 29 20 20 20 20 20 21 15 19 20 20 20 20 30 18 23 0 0 0 0 0 0 0 0 0 0 13 4 4 5 2 2 2 2 2 8 9 9 9 9 12 0 0 1 0 0 0 0 0 0 0 0 0 0 11 9 10 2 2 2 2 2 2 2 2 2 2 2 2 2 2 2 2 2 2 2 2 2 2 2 2 2 2 2 2 2 2 2 2 2 2 2 2 6 0 16 16 16 16 
18 18 18 18 18 18 18 23 15 22 18 18 18 18 18 18 29 20 21 0 0 0 0 0 0 0 0 0 0 0 13 4 4 4 5 2 2 2 2 2 2 6 0 0 0 0 0 0 0 0 0 16 16 11 9 10 2 2 2 3 4 4 4 4 4 4 4 4 4 4 4 4 4 4 4 4 4 4 4 4 4 4 4 4 4 4 4 4 4 4 4 4 4 4 14 0 16 16 16 16 
18 18 18 18 18 18 18 23 15 22 18 18 18 18 18 18 18 18 23 0 0 0 0 0 0 0 0 0 0 0 0 0 0 0 13 4 4 4 4 5 2 6 0 0 0 0 0 0 16 16 16 16 11 10 2 2 2 3 4 14 0 0 0 0 16 16 16 16 16 16 16 16 16 0 0 0 0 0 0 0 0 0 0 0 0 0 0 0 0 0 0 0 0 0 0 16 16 16 16 16 
18 27 25 25 25 25 25 26 15 24 25 25 25 25 25 25 25 28 23 0 0 0 0 0 0 0 0 0 16 16 16 16 16 0 0 1 0 0 0 7 2 6 0 0 0 16 16 16 16 0 0 11 10 2 2 3 0 14 0 0 0 0 0 0 0 0 0 16 16 16 16 16 16 16 16 16 16 16 16 0 0 0 0 0 0 0 0 0 0 0 16 16 16 16 16 16 16 16 16 16 
27 26 0 0 0 0 0 0 0 0 0 0 0 0 0 0 1 22 29 21 0 0 0 0 0 0 0 0 0 16 16 16 16 16 16 0 0 0 0 7 2 6 0 0 0 0 0 0 0 0 11 10 2 2 3 14 16 16 16 0 0 0 0 0 0 0 0 16 16 16 16 16 16 16 16 16 16 16 16 16 16 16 16 16 16 16 16 16 16 16 16 16 16 16 16 16 16 16 16 16 
23 0 0 0 0 0 0 0 0 0 0 0 0 0 0 0 0 22 18 29 21 0 0 0 0 0 0 0 0 0 0 0 16 16 16 16 16 0 0 7 2 8 9 9 9 9 9 11 0 11 10 2 2 3 14 16 16 0 0 0 0 0 0 0 0 0 0 16 16 16 16 16 16 16 16 16 16 16 16 16 16 16 16 16 16 16 16 16 16 16 16 16 16 16 16 16 16 16 16 16 
23 0 0 0 0 0 0 0 0 0 0 0 0 0 0 0 1 24 28 18 29 21 0 0 0 0 0 0 0 0 0 0 0 16 16 16 16 0 0 7 2 2 2 2 2 2 2 8 9 10 2 2 3 14 16 0 0 0 0 0 0 0 0 0 0 0 0 0 16 16 16 16 16 16 16 16 16 16 16 16 16 16 16 16 16 16 16 16 16 16 16 16 16 16 16 16 16 16 16 16 
23 0 0 0 0 0 0 0 0 0 0 0 0 0 0 0 0 0 24 25 28 29 21 0 0 0 0 0 0 0 0 0 0 16 16 16 16 0 0 13 4 4 4 4 4 5 2 2 2 2 2 3 14 0 0 0 0 0 0 16 16 16 0 0 0 0 0 0 16 16 16 16 16 16 16 16 16 16 16 16 16 16 16 16 16 16 16 16 16 16 16 16 16 16 16 16 16 16 16 16 
23 0 0 0 0 0 0 0 0 0 0 0 0 0 0 0 0 0 0 0 22 18 29 21 0 0 0 0 0 0 0 0 0 0 0 0 0 0 0 16 16 16 16 16 0 13 4 4 4 4 4 14 0 0 0 0 0 16 16 16 0 0 0 0 0 0 0 0 16 16 16 16 16 16 16 16 16 16 16 16 16 16 16 16 16 16 16 16 16 16 16 16 16 16 16 16 16 16 16 16 
23 0 0 0 0 0 0 0 0 0 0 0 0 0 0 0 0 0 0 0 24 28 18 29 21 0 0 0 0 0 0 0 0 0 0 0 0 0 0 16 16 0 0 0 0 0 0 16 16 16 16 16 16 16 16 0 0 0 0 0 0 0 0 0 0 0 0 0 16 16 16 16 16 16 16 16 16 16 16 16 16 16 16 16 16 16 16 16 16 16 16 16 16 16 16 16 16 16 16 16 
23 0 0 0 0 0 0 0 0 0 0 0 0 0 0 0 0 0 0 0 0 22 18 18 29 21 0 0 0 0 0 0 0 0 0 0 0 0 0 0 0 0 0 0 0 0 16 16 0 0 0 0 0 0 0 0 0 0 0 0 0 0 0 0 0 0 0 0 0 16 16 16 16 16 16 16 16 0 0 0 0 16 16 16 16 16 16 16 16 16 16 16 16 16 16 16 16 16 16 16 
23 0 0 0 0 0 0 0 0 0 0 0 0 0 0 0 0 0 0 0 0 22 18 18 18 29 21 0 0 0 0 0 0 0 0 0 0 0 0 0 0 0 0 0 0 0 0 0 0 0 0 0 0 0 0 0 0 0 0 0 0 0 0 0 0 0 0 0 0 0 0 0 0 0 0 0 0 0 0 0 0 0 0 16 16 16 16 16 16 16 16 16 16 16 16 16 16 16 16 16 
23 0 0 0 0 0 0 0 0 0 0 0 0 0 0 0 0 0 0 0 0 22 18 18 18 18 23 0 0 0 0 0 0 0 0 0 0 0 0 0 0 0 0 0 0 0 0 0 0 0 0 0 0 0 0 0 0 0 0 0 0 0 0 0 0 0 0 0 0 0 0 0 0 0 0 0 0 0 0 0 0 0 0 16 16 16 16 16 16 16 16 16 16 16 16 16 16 16 16 16 
23 0 0 0 0 0 0 0 0 0 0 0 0 0 0 0 0 0 0 0 0 22 18 18 18 18 23 0 0 0 0 0 0 0 0 0 0 0 0 0 0 0 0 0 0 0 0 0 0 0 0 0 0 0 0 0 0 0 0 16 0 0 0 0 0 0 0 0 0 0 0 0 0 0 0 0 0 0 0 0 0 0 0 16 16 16 16 16 16 16 16 16 16 16 16 16 16 16 16 16 
23 0 0 0 0 0 0 0 0 0 0 0 0 0 0 0 0 0 0 0 0 22 18 18 18 18 23 0 0 0 0 0 0 0 0 0 0 0 0 0 0 0 0 0 0 1 0 0 0 0 0 0 0 0 0 0 0 0 0 0 0 0 0 0 0 0 0 0 0 0 0 0 0 0 0 0 0 0 0 0 0 0 0 16 16 16 16 16 16 16 16 16 16 16 16 16 16 16 16 16 
23 0 0 0 0 0 0 1 0 0 0 0 0 0 19 20 20 20 20 20 20 30 18 18 18 18 29 20 20 20 20 20 20 20 20 20 20 20 20 21 0 0 0 0 0 0 0 0 0 0 0 0 0 0 0 0 0 0 0 0 0 0 0 0 0 0 16 16 0 0 0 0 0 0 0 0 0 0 0 0 0 0 0 0 16 16 16 16 16 16 16 16 16 16 16 16 16 16 16 16 
23 0 0 0 0 0 0 1 0 0 0 0 0 0 22 18 18 18 18 18 18 18 18 18 18 18 18 18 18 18 18 18 18 18 18 18 18 18 18 23 0 0 0 0 0 0 0 0 0 0 0 0 0 0 0 0 0 0 16 0 0 0 0 0 0 0 0 0 0 0 0 0 0 0 0 0 0 0 0 0 0 0 0 0 0 0 16 16 16 16 16 16 16 16 16 16 16 16 16 16 
23 16 16 0 0 0 1 1 0 0 0 0 0 0 22 18 18 18 18 18 18 18 18 18 18 18 18 18 18 18 18 18 18 18 18 18 18 18 18 23 0 0 0 0 0 0 0 0 0 0 0 0 0 0 0 0 0 0 0 0 0 0 0 0 0 0 0 0 0 0 0 0 0 0 0 0 0 0 0 0 0 0 0 0 0 0 0 0 0 16 16 16 16 16 16 16 16 16 16 16 
23 16 16 0 0 16 16 16 16 16 16 16 16 16 22 18 18 18 18 18 18 18 18 18 18 18 18 18 18 18 18 18 18 18 18 18 18 18 18 23 0 0 0 0 0 0 0 0 0 0 0 0 0 0 0 0 0 0 0 0 0 0 0 0 0 0 0 0 0 0 0 0 0 0 0 0 0 0 0 0 0 0 0 0 0 0 0 0 0 0 16 16 16 16 16 16 16 16 16 16 
23 16 16 0 0 16 16 16 16 16 16 16 16 16 22 18 18 18 18 18 18 18 18 18 18 18 18 18 18 18 18 18 18 18 18 18 18 18 18 23 0 0 0 0 0 0 0 0 0 0 0 0 0 0 0 0 0 0 0 0 0 0 0 0 0 0 0 0 0 0 0 0 0 0 0 0 0 0 0 0 0 0 0 0 0 0 0 0 0 0 16 16 16 16 16 16 16 16 16 16 
23 16 16 0 0 0 1 1 31 0 0 0 0 0 22 18 18 18 18 18 18 18 18 18 18 18 18 18 18 18 18 18 18 18 18 18 18 18 18 23 0 0 0 0 0 0 0 0 0 0 0 0 0 0 0 0 0 0 0 0 0 0 0 0 0 0 0 0 0 0 0 0 0 0 0 0 0 0 0 0 0 0 0 0 0 0 0 0 0 0 16 16 16 16 16 16 16 16 16 16 
23 16 16 0 0 0 0 0 0 0 0 0 0 0 22 18 18 18 18 18 18 18 18 18 18 18 18 18 18 18 18 18 18 18 18 18 18 18 18 23 0 0 0 0 0 0 0 0 0 0 0 0 0 0 0 0 0 0 0 0 0 0 0 0 0 0 0 0 0 0 0 0 0 0 0 0 0 0 0 0 0 0 0 0 0 0 0 0 0 0 16 16 16 16 16 16 16 16 16 16 
23 16 16 16 16 16 16 16 16 16 16 16 0 0 22 18 18 18 18 18 18 18 18 18 18 18 18 18 18 18 18 18 18 18 18 18 18 18 18 23 0 0 0 0 0 0 0 0 0 0 0 0 0 0 0 0 0 0 0 0 0 16 0 0 0 0 1 0 0 0 0 0 0 0 0 0 0 0 0 0 0 0 0 0 0 0 0 0 0 0 0 16 16 16 16 16 16 16 16 16 
23 16 16 16 16 16 16 16 16 16 16 16 0 0 22 18 18 18 18 18 18 18 18 18 18 18 18 18 18 18 18 18 18 18 18 18 18 18 18 23 0 0 0 0 0 0 0 0 1 0 0 0 0 0 0 0 0 0 0 0 0 0 0 0 0 0 0 0 0 0 0 0 0 0 0 0 0 0 0 0 0 0 0 0 0 0 0 0 5 2 8 16 16 16 16 16 16 16 16 16 
23 16 0 0 0 0 0 0 0 0 0 0 0 0 22 18 18 18 18 18 18 18 18 18 18 18 18 18 18 18 18 18 18 18 18 18 18 18 18 23 0 0 0 0 0 0 0 0 0 0 0 0 0 0 0 0 0 0 0 0 0 0 0 0 0 0 0 0 0 0 0 0 0 0 16 0 0 0 0 0 0 0 0 0 0 0 0 0 0 5 2 6 16 16 16 16 16 16 16 16 
23 16 0 0 0 0 0 0 1 0 0 0 0 0 22 18 18 18 18 18 18 18 18 18 18 18 18 18 18 18 18 18 18 18 18 18 18 18 18 23 0 0 0 0 0 0 0 0 0 0 0 0 0 0 0 0 0 0 0 0 0 0 0 0 0 0 0 0 16 0 0 0 0 0 0 0 0 0 0 0 0 0 0 0 0 0 0 0 0 7 2 8 0 16 16 16 16 16 16 16 
23 16 0 0 0 16 16 16 16 16 16 16 16 16 22 18 18 18 18 18 18 18 18 18 18 18 18 18 18 18 18 18 18 18 18 18 18 18 18 23 0 0 0 0 0 0 0 0 0 0 0 0 0 0 0 0 0 0 0 0 0 1 0 0 0 0 0 0 0 0 0 0 0 0 0 0 0 0 0 0 0 0 0 0 0 0 0 0 0 0 5 2 8 0 16 16 16 16 16 16 
23 16 16 0 0 16 16 16 16 16 16 16 16 16 22 18 18 18 18 18 18 18 18 18 18 18 18 18 18 18 18 18 18 18 18 18 18 18 18 23 0 0 0 0 0 0 0 0 0 0 0 0 0 0 0 0 0 0 0 0 0 0 0 0 0 0 0 0 0 0 0 0 0 0 0 0 0 0 0 0 0 0 0 0 0 0 0 0 0 0 0 5 2 8 0 16 16 16 16 16 
23 16 16 0 0 0 1 1 0 0 0 0 1 1 22 18 18 18 18 18 18 18 18 18 18 18 18 18 18 18 18 18 18 18 18 18 18 18 18 23 0 0 0 0 0 0 0 0 0 0 0 0 0 0 0 0 0 0 0 0 0 0 0 0 0 0 0 0 0 0 0 0 0 0 0 0 0 0 0 1 0 0 0 0 0 0 0 0 0 1 0 0 5 2 8 9 9 16 16 16 
23 16 16 0 0 0 1 0 0 0 0 0 0 0 22 18 18 18 18 18 18 18 18 18 18 18 18 18 18 18 18 18 18 18 18 18 18 18 18 23 0 0 0 0 0 0 0 0 0 0 0 0 0 0 0 0 0 0 0 0 0 0 0 0 0 0 0 0 0 0 0 0 0 0 0 0 0 0 0 0 0 0 0 0 0 0 0 0 0 0 0 0 0 0 0 0 0 1 16 16 
23 16 16 16 16 16 16 16 16 16 16 16 0 0 22 18 18 18 18 18 18 18 18 18 18 18 18 18 18 18 18 18 18 18 18 18 18 18 18 23 0 0 0 0 0 0 0 0 0 0 0 0 0 0 0 0 0 0 0 0 16 0 0 0 0 0 0 0 0 0 0 0 0 0 0 0 0 0 0 0 0 0 0 0 0 0 0 0 0 0 0 0 0 0 0 19 20 20 20 20 
23 16 16 16 16 16 16 16 16 16 16 16 0 0 22 27 25 25 25 25 25 25 25 25 25 25 25 25 25 25 25 25 25 25 25 25 25 28 18 29 20 20 20 20 21 0 0 0 0 0 0 0 0 0 0 0 0 0 0 0 0 0 0 0 0 0 1 0 0 0 16 0 0 0 0 0 0 1 0 0 0 0 0 0 0 0 0 0 0 0 0 0 0 1 0 22 18 18 18 18 
23 16 0 0 0 0 0 0 0 0 0 0 0 0 22 23 0 0 0 0 0 0 0 0 0 0 0 0 0 0 0 0 0 0 0 0 0 24 25 28 18 18 18 18 23 0 0 0 0 0 0 0 0 0 0 0 0 0 0 0 0 0 0 0 0 0 0 0 0 0 0 0 0 0 0 0 0 0 0 0 0 0 0 0 0 0 0 0 0 0 0 1 0 19 20 30 18 27 25 25 
23 0 0 0 0 0 0 0 0 0 0 0 0 0 22 23 0 0 0 0 0 0 0 0 0 0 0 0 0 0 0 0 0 0 0 0 0 0 0 22 18 18 18 18 29 20 20 20 20 20 21 0 0 0 0 0 0 0 0 0 0 0 0 0 0 0 0 0 0 0 0 0 1 0 0 0 0 0 0 0 0 0 0 0 0 0 0 0 1 0 1 19 20 30 18 18 27 26 0 16 
23 0 0 0 0 0 0 0 1 1 0 0 0 0 22 23 0 0 0 0 0 0 0 0 0 0 0 0 0 0 0 0 0 0 0 0 0 0 0 24 28 18 18 18 18 18 18 18 18 18 29 20 20 20 20 21 0 0 0 0 0 0 0 0 0 0 0 0 0 0 0 0 0 0 0 0 0 0 0 0 0 0 0 0 0 0 0 0 0 19 20 30 18 18 18 27 26 0 0 16 
23 0 0 0 0 0 0 1 1 0 0 0 0 0 24 26 0 0 0 0 0 0 0 0 0 0 0 0 0 0 0 0 0 0 0 0 0 0 0 1 22 18 18 18 18 18 18 18 18 18 18 18 18 18 18 29 20 21 0 0 0 0 0 0 0 0 0 0 0 0 0 0 0 0 0 0 0 0 0 0 0 0 0 0 0 0 0 0 0 22 18 18 18 27 25 26 0 0 0 16 
23 0 0 0 0 1 1 1 0 0 0 0 0 1 15 15 0 0 0 0 0 0 0 0 0 0 0 0 0 0 0 0 0 0 0 0 0 0 0 0 24 25 25 28 18 18 18 18 18 18 18 18 18 18 18 18 18 29 21 0 0 0 0 0 0 0 0 0 0 0 0 0 0 0 0 0 0 0 0 0 0 0 0 0 0 0 0 0 0 22 18 18 27 26 0 0 0 0 0 16 
23 0 0 0 0 1 0 0 0 0 0 0 0 0 19 21 0 0 0 0 0 0 0 0 0 0 0 0 0 0 0 0 0 0 0 0 0 1 0 0 0 0 0 24 25 28 18 18 18 18 18 18 18 18 18 18 18 18 29 20 21 0 0 0 0 0 0 0 0 0 0 0 0 0 0 0 0 0 0 0 0 0 0 0 0 0 1 0 0 22 18 27 26 1 0 0 0 0 0 16 
23 0 0 0 0 1 0 0 0 0 0 0 0 0 22 23 0 0 0 0 0 0 0 0 0 0 0 0 0 0 0 0 0 0 0 0 0 0 0 0 0 0 0 0 0 24 25 25 25 25 25 25 28 18 18 18 18 18 18 18 29 21 0 0 0 0 0 0 0 0 0 0 0 0 0 0 0 0 0 0 0 0 0 0 0 1 0 0 19 30 18 23 0 0 0 0 0 0 0 16 
29 20 20 20 21 15 19 20 20 20 20 20 20 20 30 23 0 0 0 0 0 0 0 0 0 0 0 0 0 0 0 0 0 0 0 0 0 0 0 0 0 0 0 0 0 0 0 0 0 0 0 0 24 25 25 25 28 18 18 18 18 29 20 21 1 0 0 0 0 0 0 0 0 0 0 0 0 0 0 0 0 0 0 0 0 0 0 19 30 18 27 26 0 0 0 0 0 0 0 16 
18 18 18 18 23 15 22 18 18 18 18 18 18 18 18 23 0 0 0 0 0 0 0 0 0 0 0 0 0 0 0 0 0 0 0 0 0 0 0 0 0 0 0 0 0 0 0 0 0 0 0 0 0 0 0 0 22 18 18 18 18 18 18 29 20 21 0 0 0 0 0 0 0 0 0 0 0 0 0 0 0 1 0 0 0 0 0 22 18 18 23 0 0 0 0 0 0 0 0 16 
18 18 18 18 23 15 22 18 18 18 18 18 18 18 18 23 0 0 0 0 0 0 0 0 0 0 0 0 0 0 0 0 0 0 0 0 0 0 0 0 0 0 0 0 0 0 1 0 0 0 0 0 0 0 0 0 24 25 25 25 28 18 18 18 18 29 20 20 21 0 0 0 0 0 0 0 1 0 0 0 0 0 0 0 0 0 0 22 18 18 23 0 0 0 0 0 0 0 0 16 
18 18 18 18 23 15 22 18 18 18 18 18 18 18 18 29 20 20 20 20 20 20 20 20 20 20 20 20 20 20 20 20 20 20 20 21 0 0 0 0 1 0 0 0 0 0 0 0 0 0 0 0 1 0 0 0 0 0 0 0 22 18 18 18 18 18 18 18 29 20 21 0 0 0 0 0 0 0 0 0 0 0 0 0 1 0 0 22 18 27 26 0 0 0 0 0 0 0 0 16 
18 18 27 25 26 15 24 25 25 25 25 25 25 25 28 18 18 18 18 18 18 18 18 18 18 18 18 18 18 18 18 18 18 18 18 23 0 0 0 0 0 0 0 0 0 0 0 0 0 0 0 0 0 0 0 0 0 0 0 0 24 25 28 18 18 18 18 18 18 18 29 21 0 0 0 0 0 0 0 0 1 0 0 0 0 0 0 24 25 26 0 0 0 0 0 0 0 0 0 16 
18 18 23 0 0 0 0 0 1 0 0 1 0 0 22 18 18 18 18 18 18 18 18 18 18 18 18 18 18 18 18 18 18 18 18 23 0 0 0 0 0 0 0 0 0 0 0 0 0 1 0 0 0 0 0 0 0 0 0 0 0 0 22 18 18 18 18 18 27 25 28 29 20 21 0 0 0 0 0 0 0 0 0 0 0 0 0 15 15 15 0 0 0 0 0 0 0 0 0 16 
18 18 23 0 1 0 0 0 0 0 0 0 0 0 22 18 18 18 18 18 18 18 18 18 18 18 18 18 18 18 18 18 18 18 18 23 0 0 0 0 0 0 0 0 1 0 0 0 0 0 0 0 1 0 0 0 0 0 0 0 0 0 24 25 25 25 28 18 23 16 22 18 18 23 0 0 0 0 0 0 0 0 0 0 0 0 0 19 20 21 0 0 0 0 0 0 0 0 0 16 
18 18 23 0 0 19 20 20 20 20 20 21 0 0 22 18 18 18 18 18 18 18 18 18 18 18 18 18 18 18 18 18 18 18 18 23 0 0 0 0 0 0 0 0 0 0 0 0 0 0 0 0 0 0 0 0 1 0 0 1 0 0 0 0 0 1 22 18 29 20 30 18 18 29 21 0 0 0 1 0 0 0 0 1 0 0 0 22 18 29 21 0 0 0 0 0 0 0 0 16 
18 18 23 1 0 22 18 18 18 18 18 23 0 1 22 18 18 18 18 18 18 18 18 18 18 18 18 18 18 18 18 18 18 18 18 23 0 0 0 0 0 0 0 0 0 0 16 16 16 16 16 0 0 0 0 0 0 0 0 0 0 1 0 0 0 0 24 25 25 28 18 18 18 18 29 21 0 0 0 0 0 0 0 0 0 0 0 24 28 18 29 21 0 0 0 0 0 0 0 16 
18 18 23 0 0 22 18 18 18 18 18 23 0 0 22 18 18 18 18 27 25 25 25 25 25 25 25 25 28 18 18 18 18 18 18 23 0 0 0 0 0 0 16 16 16 16 16 16 16 16 16 16 16 16 16 0 0 0 0 0 0 0 0 0 0 0 0 0 0 24 25 25 28 18 18 29 21 0 0 0 0 0 0 0 0 0 0 0 24 28 18 29 21 0 0 0 0 0 0 16 
18 18 23 0 1 24 25 25 25 25 25 26 0 0 22 18 18 18 18 23 0 0 0 0 0 0 0 0 22 18 18 18 18 18 18 23 0 0 0 0 0 16 16 16 16 16 0 0 0 0 0 16 16 16 16 16 16 16 16 16 16 16 0 0 0 0 0 0 1 0 0 0 22 18 18 18 29 21 0 0 0 0 0 1 0 0 0 0 0 24 28 18 29 21 0 0 0 0 0 16 
18 18 23 0 0 0 0 1 1 0 0 0 0 0 24 25 25 25 25 26 0 19 20 20 20 20 21 0 22 18 18 18 18 18 18 23 0 0 0 0 16 16 16 0 0 0 0 0 0 0 16 16 16 16 16 16 16 16 16 16 16 16 16 16 16 0 0 0 0 0 0 0 24 25 25 25 28 29 21 0 0 1 0 0 0 0 0 1 0 0 24 28 18 29 21 0 0 0 0 16 
18 18 23 0 0 0 0 0 0 0 0 0 1 0 15 15 15 15 15 15 0 22 18 18 18 18 23 0 22 18 18 18 18 18 18 23 0 0 0 0 0 0 1 0 0 0 0 0 0 1 0 0 0 0 0 0 0 0 0 0 16 16 16 16 16 16 0 0 0 0 0 0 0 0 0 0 22 18 29 21 0 0 0 0 0 0 0 0 0 0 0 24 28 18 29 21 0 0 0 16 
18 18 29 20 20 20 20 20 20 20 20 20 20 20 20 20 20 20 20 21 0 22 18 18 18 18 23 0 22 18 18 18 18 18 18 29 20 20 20 21 0 0 1 0 0 0 0 0 0 1 0 0 0 0 0 0 0 0 0 1 0 0 0 0 0 16 16 0 0 0 1 0 0 0 0 0 22 18 18 29 20 20 21 0 0 0 0 0 0 0 0 0 24 28 18 29 21 0 0 16 
18 18 18 18 18 18 18 18 18 18 18 18 18 18 18 18 18 18 18 23 0 22 18 27 28 18 23 0 22 18 18 18 27 25 25 28 18 18 18 23 0 0 0 16 16 16 16 0 0 0 0 0 0 0 0 0 0 0 0 1 0 0 0 0 0 0 16 16 16 16 0 0 0 0 0 0 22 18 18 18 18 18 29 21 0 0 0 0 0 0 0 0 0 24 28 18 29 21 0 16 
18 18 18 18 18 18 18 18 18 18 18 18 18 18 18 18 18 18 18 23 0 22 18 29 30 18 23 0 22 18 18 18 23 1 1 22 18 18 18 23 0 0 0 16 16 16 16 16 16 16 16 16 16 16 16 16 16 0 0 0 0 0 0 0 0 0 0 1 16 16 16 0 0 0 1 0 24 25 28 18 18 18 18 29 20 21 0 1 0 0 0 0 0 0 24 28 18 29 21 16 
18 18 18 18 18 18 18 18 18 18 18 18 18 18 18 18 18 18 18 23 0 22 18 18 18 18 23 0 22 18 18 18 29 20 20 30 18 18 18 23 0 0 0 16 16 16 16 16 16 16 16 16 16 16 16 16 16 16 16 16 16 16 16 16 0 0 0 1 0 1 16 16 16 16 16 1 0 0 24 28 18 18 18 18 18 23 0 0 0 1 0 0 1 0 0 22 18 18 23 16 
18 18 18 18 18 18 18 18 27 25 25 25 25 25 25 25 28 18 18 23 0 24 25 25 25 25 26 0 22 18 18 18 18 18 18 18 18 18 18 23 16 16 16 16 16 16 16 16 16 16 16 16 16 16 16 16 16 16 16 16 16 16 16 16 16 16 16 16 16 0 16 16 16 16 16 16 16 0 0 22 18 18 18 18 18 23 0 0 0 0 0 0 0 0 0 22 18 18 23 16 
18 18 18 18 18 18 18 18 23 19 20 20 20 20 20 21 22 18 18 23 0 0 0 0 0 0 0 0 22 18 18 18 18 18 18 18 18 18 18 23 16 0 1 1 0 0 0 0 0 0 0 0 0 0 0 0 1 1 1 1 1 1 1 0 0 16 16 16 16 0 16 16 16 16 16 16 16 0 16 24 25 25 28 18 18 29 21 0 0 0 0 0 0 0 0 22 18 18 23 16 
18 18 18 18 18 18 18 18 23 22 18 18 18 18 18 23 22 18 18 29 20 20 20 20 20 20 20 20 30 18 18 18 18 18 18 18 18 18 18 23 16 0 16 16 16 16 16 16 16 16 16 16 16 0 0 16 16 16 16 16 16 16 16 16 0 0 16 16 16 0 16 16 16 16 16 16 16 0 16 16 16 16 24 28 18 18 29 21 0 0 0 0 0 0 0 22 18 18 23 16 
18 18 18 18 18 18 18 18 23 22 18 18 18 18 18 23 22 18 18 18 18 18 18 18 18 18 18 18 18 18 18 18 18 18 18 18 18 18 18 23 16 0 16 16 0 0 1 1 1 1 16 16 16 16 0 16 16 16 16 16 16 16 16 16 16 1 16 16 16 0 16 16 16 16 16 16 16 0 16 16 16 16 16 24 28 18 18 29 21 0 0 0 1 0 0 22 18 18 23 16 
18 18 18 18 18 18 18 18 23 22 18 18 18 18 18 23 22 18 18 18 18 18 18 18 18 18 18 18 18 18 27 25 25 25 28 18 18 18 18 23 16 0 16 16 16 16 16 16 16 0 0 0 0 0 0 16 16 16 16 16 1 16 16 16 0 1 16 16 16 1 16 16 16 16 16 16 16 0 16 16 0 0 16 16 24 28 18 18 29 21 0 0 0 0 0 22 18 18 23 16 
18 18 18 18 18 18 18 18 23 22 18 18 18 18 18 23 22 18 18 18 18 18 18 18 18 18 18 18 18 18 23 16 16 16 22 18 18 18 18 23 16 0 16 16 0 0 0 0 16 16 16 16 16 16 0 16 16 16 16 16 0 16 16 16 0 16 16 16 16 0 16 16 16 16 16 16 0 0 0 0 0 0 0 16 16 24 25 28 18 29 20 20 20 20 20 30 27 25 26 16 
18 18 18 18 18 18 18 18 23 22 18 18 18 18 18 23 22 18 18 18 18 18 18 18 18 18 18 18 18 18 23 16 16 1 22 18 18 18 18 23 16 0 16 16 0 16 16 0 16 16 16 16 16 16 0 16 16 16 16 16 0 16 16 16 0 0 16 16 16 0 16 16 16 16 0 0 11 9 12 0 1 0 0 0 16 16 16 24 28 18 18 18 18 18 18 27 26 16 16 16 
18 18 18 18 18 18 18 18 23 22 18 18 18 18 18 23 22 18 18 18 18 18 18 18 18 18 18 18 18 18 29 20 20 20 30 18 18 18 18 23 16 1 16 16 0 16 16 0 16 16 0 0 0 16 0 16 16 16 16 16 0 16 16 16 16 0 16 16 16 0 16 16 16 0 0 11 10 2 8 12 0 0 0 0 0 0 16 16 22 18 18 18 18 27 25 26 16 0 0 16 
18 18 18 18 18 18 18 18 23 24 25 25 25 25 25 26 22 18 18 18 18 18 18 18 18 18 18 18 18 18 18 18 18 18 18 18 18 18 18 23 16 0 16 16 0 16 16 0 16 16 16 16 0 16 0 16 16 16 16 16 0 16 16 16 16 0 0 16 16 0 16 16 0 0 0 7 2 15 2 6 0 16 0 0 0 0 16 16 22 27 25 25 25 26 16 16 0 0 0 16 
18 18 18 18 18 18 18 18 29 20 20 20 20 20 20 20 30 18 18 18 18 18 18 18 18 18 18 18 18 18 18 18 18 18 18 18 18 18 18 23 16 1 16 16 0 16 16 0 0 0 0 0 0 16 16 16 16 16 16 16 0 16 16 16 1 0 1 16 16 0 16 16 0 0 0 7 2 15 2 6 0 16 0 0 0 0 16 16 22 23 16 16 16 16 0 0 0 0 0 16 
18 18 18 18 18 18 18 18 18 18 18 18 18 18 18 18 18 18 18 18 18 18 18 18 18 18 18 18 18 18 18 18 18 18 18 18 18 18 18 23 16 0 16 16 0 16 16 0 16 16 16 16 16 16 16 16 1 1 0 0 0 16 16 16 0 0 0 16 16 0 16 16 0 0 1 13 5 2 3 14 0 0 0 0 0 0 16 16 22 23 16 0 0 0 0 0 0 0 0 16 
18 18 18 18 18 18 18 18 18 18 18 18 18 18 18 18 18 18 18 18 18 18 18 18 18 18 18 18 18 18 18 18 18 18 18 18 18 18 18 23 16 0 0 0 1 16 16 0 16 16 16 16 16 16 16 16 1 1 16 16 16 16 16 16 0 0 0 0 0 1 16 16 11 9 9 9 10 2 8 12 0 0 1 0 0 0 16 16 22 23 16 0 0 0 0 0 0 0 0 16 
18 18 18 18 18 18 18 18 18 18 18 18 18 18 18 18 18 18 18 18 18 18 18 18 18 18 18 18 18 18 18 18 18 18 18 18 18 18 18 23 16 16 16 16 16 16 16 0 16 16 0 0 0 0 0 0 1 16 16 16 16 16 16 16 1 0 0 16 16 16 16 16 7 17 17 17 17 15 17 6 0 1 0 1 0 0 16 16 22 23 16 0 0 0 0 0 0 0 0 16 
18 18 18 18 18 18 18 18 18 18 18 18 18 18 18 18 18 18 18 18 18 18 18 18 18 18 18 18 18 18 18 27 25 25 25 25 25 25 25 26 16 16 16 16 16 16 16 1 16 16 16 16 16 16 16 16 0 16 16 16 16 16 16 16 0 0 1 16 16 16 16 16 7 17 15 15 15 15 17 6 0 0 0 0 0 16 16 19 30 23 16 0 0 0 0 0 0 0 0 16 
18 18 18 18 18 18 18 18 18 18 18 18 18 18 18 18 18 18 18 18 18 18 18 18 18 18 27 25 25 25 25 26 0 0 0 0 0 0 0 0 16 16 16 16 16 16 16 0 16 16 16 16 16 16 16 16 0 0 0 0 0 0 0 0 0 0 0 16 16 16 16 16 7 17 15 15 15 15 17 6 0 0 0 0 0 16 16 24 25 26 16 0 0 0 0 0 0 0 0 16 
18 18 18 18 18 18 18 18 18 18 18 18 18 18 18 18 18 18 18 18 18 18 18 18 18 18 23 15 15 15 15 15 1 0 0 0 0 0 0 1 0 0 1 0 0 0 0 1 16 16 0 0 0 16 16 16 16 16 16 16 16 16 16 16 16 16 16 16 16 16 16 16 16 17 17 17 15 17 17 6 0 0 0 0 1 1 1 1 1 1 1 1 0 0 0 0 0 0 0 16 
18 18 18 18 18 18 18 18 18 18 18 18 18 18 18 18 18 18 18 18 18 18 18 18 18 18 29 20 20 20 20 21 0 0 0 0 0 0 0 0 16 16 16 16 16 16 16 16 16 16 0 0 0 0 0 0 0 0 0 0 0 0 0 0 0 0 0 0 0 0 0 0 0 4 4 4 0 16 16 16 16 16 16 16 16 16 1 0 0 0 0 0 0 0 0 0 0 0 0 16 
18 18 18 18 18 18 18 18 18 18 18 18 18 18 18 18 18 18 18 18 18 18 18 18 18 18 18 18 18 18 18 23 16 16 16 16 16 16 16 16 16 16 16 16 16 16 16 16 16 16 16 16 16 16 16 16 16 16 16 16 16 16 16 16 16 16 16 16 16 16 16 16 16 16 16 16 16 16 16 16 16 16 16 16 16 16 16 16 16 16 16 16 16 16 16 16 16 16 16 16 
